MAIN
,-------------------------------------------------.                        ,-------------------------------------------------.
|    Q    |    W    |    F    |    P    |    G    |                        |    J    |    M    |    U    |    Y    |  BSPC   |
|---------+---------+---------+---------+---------|                        |---------+---------+---------+---------+---------|
|    A    |    R    |    S    |    T    |    D    |                        |    H    |    N    |    E    |    I    |    O    |
|---------+---------+---------+---------+---------|                        |---------+---------+---------+---------+---------|
|  MISC   |    X    |    C    |    V    |    B    |                        |    Z    |    L    |    K    |   TAB   |   ENT   |
`---------------------------------------+---------+---------.    ,---------+---------+---------------------------------------'
                                        |  LOWER  |   SPC   |    |  LSFT   |  RAISE  |
                                        `-------------------'    `-------------------'
LOWER
,-------------------------------------------------.                        ,-------------------------------------------------.
|   TAB   |  CAPS   |  LCTL   |  LALT   |  LGUI   |                        |         |         |    [    |    ]    |  BSPC   |
|---------+---------+---------+---------+---------|                        |---------+---------+---------+---------+---------|
|   ESC   |   HM    |   UP    |   ED    |         |                        |    _    |    (    |    )    |    {    |    }    |
|---------+---------+---------+---------+---------|                        |---------+---------+---------+---------+---------|
|         |  LEFT   |  DOWN   |  RGHT   |         |                        |         |    <    |    >    |    [    |    ]    |
`---------------------------------------+---------+---------.    ,---------+---------+---------------------------------------'
                                        |         |   SPC   |    |  LSFT   |         |
                                        `-------------------'    `-------------------'
RAISE
,-------------------------------------------------.                        ,-------------------------------------------------.
|    `    |    &    |    *    |    ~    |         |                        |    =    |    7    |    8    |    9    |  BSPC   |
|---------+---------+---------+---------+---------|                        |---------+---------+---------+---------+---------|
|   ESC   |    $    |    %    |    ^    |         |                        |    +    |    4    |    5    |    6    |    0    |
|---------+---------+---------+---------+---------|                        |---------+---------+---------+---------+---------|
|         |    !    |    @    |    #    |    =    |                        |    -    |    1    |    2    |    3    |   DEL   |
`---------------------------------------+---------+---------.    ,---------+---------+---------------------------------------'
                                        |         |   SPC   |    |  LSFT   |         |
                                        `-------------------'    `-------------------'
ADJUST
,-------------------------------------------------.                        ,-------------------------------------------------.
|         |   F1    |   F2    |   F3    |   F4    |                        |  VOLD   |  VOLU   |  MUTE   | CG_SWAP | CG_NORM |
|---------+---------+---------+---------+---------|                        |---------+---------+---------+---------+---------|
|         |   F5    |   F6    |   F7    |   F8    |                        | RBTVAR  |         |         | SCRSHT  |  MOUSE  |
|---------+---------+---------+---------+---------|                        |---------+---------+---------+---------+---------|
|         |   F9    |   F10   |   F11   |   F12   |                        |RBTNEWVAR|         |         |SCRSHTSV |  DOCMD  |
`---------------------------------------+---------+---------.    ,---------+---------+---------------------------------------'
                                        |         |         |    |         |         |
                                        `-------------------'    `-------------------'
MISC
,-------------------------------------------------.                        ,-------------------------------------------------.
|         |         | QK_LEAD |  MODS   |  REDO   |                        |         |    ?    |    |    |    :    |    "    |
|---------+---------+---------+---------+---------|                        |---------+---------+---------+---------+---------|
|   ALL   |         |  SAVE   |         |  FIND   |                        |         |    /    |    \    |    ;    |    '    |
|---------+---------+---------+---------+---------|                        |---------+---------+---------+---------+---------|
|         |  UNDO   |   CUT   |  COPY   |  PASTE  |                        |         |    ,    |    .    |    /    |    \    |
`---------------------------------------+---------+---------.    ,---------+---------+---------------------------------------'
                                        |         |   SPC   |    |  LSFT   |         |
                                        `-------------------'    `-------------------'
MODS
,-------------------------------------------------.                        ,-------------------------------------------------.
|   Ctl   | AltCtl  | CtlSft  |   MEH   |         |                        |         |         |         |         |         |
|---------+---------+---------+---------+---------|                        |---------+---------+---------+---------+---------|
|   GUI   | AltGUI  | GUISft  |SftAltGUI|         |                        |         |         |         |         |         |
|---------+---------+---------+---------+---------|                        |---------+---------+---------+---------+---------|
|         |   Alt   | SftAlt  |         |         |                        |         |         |         |         |         |
`---------------------------------------+---------+---------.    ,---------+---------+---------------------------------------'
                                        |         |   SPC   |    |  LSFT   |         |
                                        `-------------------'    `-------------------'
MOUSE
,-------------------------------------------------.                        ,-------------------------------------------------.
|         |  ACL0   |  ACL1   |  ACL2   |         |                        |         |         |  BTN3   |         |         |
|---------+---------+---------+---------+---------|                        |---------+---------+---------+---------+---------|
|  RTRN   |         |  MS_U   |         |         |                        |         |  BTN1   |  BTN2   |  WH_U   |         |
|---------+---------+---------+---------+---------|                        |---------+---------+---------+---------+---------|
|         |  MS_L   |  MS_D   |  MS_R   |         |                        |         |         |         |  WH_D   |         |
`---------------------------------------+---------+---------.    ,---------+---------+---------------------------------------'
                                        |  RTRN   |   SPC   |    |  LSFT   |  RTRN   |
                                        `-------------------'    `-------------------'
DOCMD
,-------------------------------------------------.                        ,-------------------------------------------------.
|         |  DELLN  |  CPLN   |  PSTUP  |         |                        |  REDO   | DELBAK  |         | DELFWD  |  UNDO   |
|---------+---------+---------+---------+---------|                        |---------+---------+---------+---------+---------|
|  RTRN   |  CUTLN  | JUMPUP  |  PSTDN  |         |                        |         | CUTBAK  | MVLNUP  | CUTFWD  |   CUT   |
|---------+---------+---------+---------+---------|                        |---------+---------+---------+---------+---------|
|         | JUMPLT  | JUMPDN  | JUMPRT  |         |                        |  COPY   | HLTBAK  | MVLNDN  | HLTFWD  |  PASTE  |
`---------------------------------------+---------+---------.    ,---------+---------+---------------------------------------'
                                        |   NAV   |  LSFT   |    |  LSFT   |  RTRN   |
                                        `-------------------'    `-------------------'
NAV
,-------------------------------------------------.                        ,-------------------------------------------------.
|         |  DELLN  |  CPLN   |  PSTUP  |         |                        |         | DELBAK  |         | DELFWD  |         |
|---------+---------+---------+---------+---------|                        |---------+---------+---------+---------+---------|
|  RTRN   |   HM    |   UP    |   ED    |         |                        |         | CUTBAK  | MVLNUP  | CUTFWD  |         |
|---------+---------+---------+---------+---------|                        |---------+---------+---------+---------+---------|
|         |  LEFT   |  DOWN   |  RGHT   |         |                        |         | HLTBAK  | MVLNDN  | HLTFWD  |         |
`---------------------------------------+---------+---------.    ,---------+---------+---------------------------------------'
                                        |         |  LSFT   |    |  LSFT   |  RTRN   |
                                        `-------------------'    `-------------------'